{
  "version": 1,
  "gridSize": 13,
  "name": "经典关卡1",
  "grid": [
    [0, 0, 0, 0, 0, 0, 0, 0, 0, 0, 0, 0, 0],
    [2, 1, 0, 1, 2, 0, 1, 0, 2, 1, 0, 1, 2],
    [1, 1, 0, 1, 1, 0, 1, 0, 1, 1, 0, 1, 1],
    [0, 0, 0, 0, 0, 0, 0, 0, 0, 0, 0, 0, 0],
    [0, 1, 1, 0, 2, 1, 0, 1, 2, 0, 1, 1, 0],
    [0, 1, 0, 0, 0, 1, 0, 1, 0, 0, 0, 1, 0],
    [1, 1, 0, 1, 0, 0, 0, 0, 0, 1, 0, 1, 1],
    [0, 0, 0, 1, 0, 1, 2, 1, 0, 1, 0, 0, 0],
    [0, 1, 0, 1, 0, 1, 1, 1, 0, 1, 0, 1, 0],
    [0, 1, 0, 0, 0, 0, 0, 0, 0, 0, 0, 1, 0],
    [0, 0, 0, 0, 0, 1, 1, 1, 0, 0, 0, 0, 0],
    [0, 0, 0, 0, 0, 1, 1, 1, 0, 0, 0, 0, 0],
    [0, 0, 0, 0, 0, 1, 5, 1, 0, 0, 0, 0, 0]
  ]
}
